NO ./path_to_the_north_texture
SO ./path_to_the_south_texture
WE ./path_to_the_west_texture
EA ./path_to_the_east_texture


F 80,80,80
C 197,197,197


        1111111111111111111111111
        1000000000110000000000001
        1001000001110000000000001
        1001000000000000000000001
111111111001000001110000000000001
100000000001000001110111111111111
11110111111111000000000000001
11110111111111000000000000001
11000000110101011100000000001
10000000000000001100000000001
10000000000000001111010000001
11000001110101011111011100N01
11110111 1110101 101111000001
11111111 1111111 111111111111