NO ./assets/wall1.xpm
SO ./assets/wall2.xpm
WE ./assets/wall3.xpm
EA ./assets/wood.xpm

F 80,80,80
C 10,100,197

        1111111111111111111111111
        1000000000110000000000001
        1000000000000000000000101
        1011000001110000000000001
        1001000000000000000000001
111111111011000001110000000000001
100000000011000001110111111111111
11111111111111011100000010001
10101111111111011101010010001
10000000110101011100000010001
100S0000000000001100000010001
10000000000000001101010010001
11000001110101011111011110011
11110111 1110101 101111010001
11111111 1111111 111111111111
