NO ./path_to_the_north_texture
SO ./path_to_the_south_texture
WE ./path_to_the_west_texture
EA ./path_to_the_east_texture


F 80,80,80
C 197,197,197


11111111111111111111111111111111111111111111111111
11111111111111111111111111111111111111111111111111
11111111111111111111111101111111111111111111111111
11111111111111111111111001111111111111111111111111
11111111111100000000011001111111111111111111111111
11111111111100000000011001111111111111111111111111
11111111111100000000001001111111111111111111111111
11111111111100000000000001111111111111111111111111
11111111111100000000001001111111111111111111111111
11111111111101000000011001111111111111111111111111
11111111111101111000011001111111111111111111111111
11111110000001111110011001111111111111111111111111
11111110000001111100011000000000000111111111111111
11111110011100000000010000000000000111111111111111
11111110011100000000011111000000000111111111111111
11111110011111000000011111111111000110000111111111
11111110011110011100000001111111000000000111111111
11111110000000011110010001111111000110000111111111
11111110011111111111110011111111001110000011111111
11000000001111111111110011111111001110000011111111
11000000000011111111110000000000001110000011111111
1100N000000011111111110000000000001110000011111111
11000000000011000110000000000000001110000011111111
11000000000011000100000000000111111100000011111111
11000000000000000000000000001111111100000011111111
11111110001111001100000000001111111100000011111111
11111110001110000110000000001111111100000000000111
11111110001110000111111100001111111100000000000111
11111110001110000111111100001111111100000000000011
11111110011110000111111100001111111100000000000011
11111110011111001111111100011111111100000000000011
11111110001100000010001110011111111100000001111111
11111110000000000000001110000000000000000001111111
11111110000000000000001110000000000000000001111111
11111111110000000000001100000001111111111111111111
11111111110000000000011100000001111111111111111111
11111111111000000000011100000001111111111111111111
11111111111000000000000000000001111111111111111111
11111111111000000010000000000001111111111111111111
11111111111000000011111111111111111111111111111111
11111111111000000011111111111111111111111111111111
11111111111000000011111111111111111111111111111111
11111111111100001011111111111111111111111111111111
11111111111000001111111111111111111111111111111111
11111111111000001111111111111111111111111111111111
11111111111000001111111111111111111111111111111111
11111111111111111111111111111111111111111111111111
11111111111111111111111111111111111111111111111111
11111111111111111111111111111111111111111111111111
11111111111111111111111111111111111111111111111111