NO ./assets/bricksx64.xpm
SO ./path_to_the_south_texture
WE ./path_to_the_west_texture
EA ./path_to_the_east_texture


F 80,80,80
C 10,100,197


11111111111111111111
11000000000000000011
11011111111111111011
11000000000000000011
11000000000000000011
11001100110011001111
11001100110111001111
11011110110111011111
11011110110111011111
11011110110111011111
11011110110111011111
11011100000000011111
110000000E0000001111
11000000000000001111
11100000000000001111
11111111111111111111